0000000000000000000000000000000000000000000000000000000000000000
0000000000000000000000000000000000000000000000000000000000000000
0000000000000000000000000000000000000000000000000000000000000000
0000000000000000000000000000000000000000000000000000000000000000
000000000000000000000000000000W0000W0000000000000000000000000000
000000000000000000W00000000000WWBBWW0000000000000000000000000000
000000000000000000W00000000PPPPPPPPPPP0000P000000000000000000000
0000PPPPPPP0000000PPPPPPP000000000000000000000000000000000000000
00000000000000000000000000000000000000000PPP00000000000000000000
0000000000000000000000000000000000000000000000000000000000000000
00000000000000000000000000000000000000PPP000PPP000000000000000E0
000000000000000000000000000000000000000000000000000000000000GGGG
00000000000000P000WWW00000000000000000000PP0000000000000GGGGGGGG
00000000PPP0000000WWW0000000000B000000000000PPP000000GGGGGGGGGGG
0S0000000000000000WWW00000000BBBB000000000000000000GGGGGGGGGGGGG
GGGGGGGG00000GGGGGGGGGG00GGGGGGGGGGG0000GGGGG0GGGGGGGGGGGGGGGGGG
GGGGGGGG00000000000000000GGGGGGGGGGG0000GGGGG0GGGGGGGGGGGGGGGGGG
GGGGGGGG00000000000000000GGGGGGGGGGG0000GGGGG0GGGGGGGGGGGGGGGGGG
GGGGGGGGGGGGGGGGGGGGGGGGGGGGGGGGGGGG0000GGGGG0GGGGGGGGGGGGGGGGGG
GGGGGGGGGGGGGGGGGGGGGGGGGGGGGGGGGGGG0000GGGGG0GGGGGGGGGGGGGGGGGG
GGGGGGGGGGGGGGGGGGGGGGGGGGGGGGGGGGGGGGGGGGGGG0GGGGGGGGGGGGGGGGGG