W0000000000000000000000000000000000000000000000W
W0000000000000000000000000000000000000000000000W
W00000000000000000000000000000PP000000000000000W
W0000000000000WWPP000000000000WW000000000000000W
W0000000PPP000WWWW000000000000WW000000000000000W
W0S00000000000WWWW000000000000WW000000000000000W
WGGGGGG00000GGGGGGGGGGG0000000GG000000000000000W
WGGGGGGGG000000GGGGGGGG0000000GG000000000000000W
WGGGGGGGGGG0000000GGGGG0000000GG000000000000000W
WGGGGGGGGGGGG0000000GGG0000000GG000000000000000W
WGGGGGGGGGGGGGG0000000G0000000GG000000000000000W
WGGGGGGGGGGGGGGGG00000G0000000GG000000000000000W
WGGGGGGGGGGGGGGGG00000G0000000GG000000000000000W
WGGGGGGGGGGGGGGGG0000000000000GG000000000000000W
WGGGGGGGGGGGGGGGG0000000000000GG000000000000000W
WGGGGGGGGGGGGGGGG0000000000000GG000000000000000W
W00000000000000000000000000000GG000000000000000W
W00000000000000000000000000000GG000000000000000W
W00000000000000000000000000000GG000000000000000W
W00000000000000000000000000000GG000000000000000W
W00000000000000000000000000000GG000000000000000W
W00000000000000000000000000000GG000000000000000W
W00000000000000000000000000000GGE00000000000000W
W00000000000000000000000000000GG000000000000000W
GGGGGGGGGGGGGGGGGGGGGGGGGGGGGGGG000000000000000W
GGGGGGGGGGGGGGGGGGGGGGGGGGGGGGGG000000000000000W
WGGGGGGGGGGGGGGGGGGGGGGGGGGGGGGG000000000000000W