000000000000000000000000000000000000000000000000
000000000000000000000000000000000000000000000000
000000000000000000000000000000000000000000000000
000000000000000000000000000000000000000000000000
000000000000000000000000000000000000000000000000
000000000000000000000000000000000000000000000000
000000000000000000000000000000000000000000000000
000000000000000000000000000000000000000000000000
000000000000000000000000000000000000000000000000
000000000000000000000000000000000000000000000000
000000000000000000000000000000000000000000000000
000000000000000000000000000000000000000000000000
000000000000000000000000000000000000000000000000
00000000000000000000000GG00000000000000000000000
0000000000000000000000000GG000000000000000000000
000000000000000000000000000000000000000000000000
000000000000000000000000000000000000000000000000
000000000000000000000000000000000000000000000000
0000000000000000000000000000000000000000000GGGGG
0000000000000000000000GGGGG0000000000000000GGGGG
00S0000000000000000000GGGGGGGG0000000000000GGGGG
GGGGG000GGGGG0000GGGGGGGGGGGGG000000000000000000
GGGGG000GGGGG0000GGGGGGGGGGGGG000000000000000000
GGGGG000GGGGG0000GGGGGGGGGGGGG0000GGG00000000E00
GGGGGGGGGGGGGGGGGGGGGGGGGGGGGGGGGGGGGGGGGGGGGGGG
GGGGGGGGGGGGGGGGGGGGGGGGGGGGGGGGGGGGGGGGGGGGGGGG
GGGGGGGGGGGGGGGGGGGGGGGGGGGGGGGGGGGGGGGGGGGGGGGG