00000000000000000000000000000000000000000000000W
00000000000000000000000000000000000000000000000W
000000000000000000000000000000PP000000000000000W
00000000000000WWPP000000000000WW000000000000000W
00000000PPP000WWWW000000000000WW000000000000000W
00S00000000000WWWW000000000000WW000000000000000W
GGGGGGG00000GGGGGGGGGGG0000000GG000000000000000W
GGGGGGGGG000000GGGGGGGG0000000GG000000000000000W
GGGGGGGGGGG0000000GGGGG0000000GG000000000000000W
GGGGGGGGGGGGG0000000GGG0000000GG000000000000000W
GGGGGGGGGGGGGGG0000000G0000000GG000000000000000W
GGGGGGGGGGGGGGGGG00000G0000000GG000000000000000W
GGGGGGGGGGGGGGGGG00000G0000000GG000000000000000W
GGGGGGGGGGGGGGGGG0000000000000GG000000000000000W
GGGGGGGGGGGGGGGGG0000000000000GG000000000000000W
GGGGGGGGGGGGGGGGG0000000000000GG000000000000000W
GGGGGGG00000000000000000000000GG000000000000000W
GGGGGGG00BBBB00000000000000000GG000000000000000W
GGGGGGG000BBBBBBBB000000000000GG000000000000000W
GGGGGGG00BBBB00000000000000000GG000000000000000W
GGGGGGG00BBBB00000000000000000GG000000000000000W
GGGGGGG00BBBB00000000000000000GG000000000000000W
GGGGGGG00BBBB00000000000000000GGE00000000000000W
GGGGGGG00BBBB00000000000000000GG000000000000000W
GGGGGGGGGGGGGGGGGGGGGGGGGGGGGGGG000000000000000W
GGGGGGGGGGGGGGGGGGGGGGGGGGGGGGGG000000000000000W
GGGGGGGGGGGGGGGGGGGGGGGGGGGGGGGG000000000000000W