00000000000000000000000000000000
00000000000000000000000000000000
000000000000000000000000000000WW
00000000000000WWWW000000000000WW
00000000PPP000WWWW000000000000WW
00S00000000000WWWW000000000000WW
GGGGGGG00000GGGGGGGGGGG0000000GG
GGGGGGGGG000000GGGGGGGG0000000GG
GGGGGGGGGGG0000000GGGGG0000000GG
GGGGGGGGGGGGG0000000GGG0000000GG
GGGGGGGGGGGGGGG0000000G0000000GG
GGGGGGGGGGGGGGGGG00000G0000000GG
GGGGGGGGGGGGGGGGG00000G0000000GG
GGGGGGGGGGGGGGGGG0000000000000GG
GGGGGGGGGGGGGGGGG0000000000000GG
GGGGGGGGGGGGGGGGG0000000000000GG
GGGGGGG00000000000000000000000GG
GGGGGGG00BBBB00000000000000000GG
GGGGGGG000EBBBBBBB000000000000GG
GGGGGGGGGGGGGGGGGGGGGGGGGGGGGGGG
GGGGGGGGGGGGGGGGGGGGGGGGGGGGGGGG
