0000000000000000
0000000000WW0000
0S00000000WW0000
GGGGGGGGGGGGGGGG
GGGGGGGGGGGGGGGG