0000000000000000
0000000000WW0000
0S00000000WW00E0
0000000000000000
0000000000000000