0000000000S00000
0000000000WW0000
0S00000000WW00E0
GGGGGGGGGGGGGGGG
GGGGGGGGGGGGGGGG