WWWWWWWWWWWWWWWW
WWWWWWWWWWWWWWWW
WSWWWWWWWWWWWWEW
GGGGGGGGGGGGGGGG
GGGGGGGGGGGGGGGG