0000000000000000
0000000000WW0000
0000000000WW00E0
GGGGGGGGGGGGGGGG
GGGGGGGGGGGGGGGG